+-+-+-+-+-+-+-+-+-+-+-+-+-+-+-+-+
|                               |
+ +-+-+-+-+-+-+-+-+-+-+-+-+-+ +-+
| |                             |
+ + +-+-+-+-+-+-+-+-+-+-+-+-+ + +
| | |         |               | |
+ + + + +-+-+ +-+ +-+-+-+-+-+-+ +
| | | |     |   |             | |
+ + + + + +-+-+ +-+-+-+-+-+-+ + +
| | | | |     |     |   |   | | |
+ + + + + + +-+ +-+ + + + + + + +
| | | | | |   |   |   | | | | | |
+ + + + + + + +-+ +-+-+ + + + + +
| | | | | | |   |   |   | | | | |
+ + + +-+ + + + +-+-+ +-+ + + + +
| | | | |   | |   |     | | | | |
+ + + + + + + + + + +-+-+ + + + +
| | | | | |   |   |     | | | | |
+ + + + + +-+ +-+-+-+-+ + + + + +
| | | | |     |       | | | | | |
+ + + + +-+-+-+-+-+ +-+ + + + + +
| | | | |         |   | | | | | |
+ + + + + +-+-+-+ +-+ + + + + + +
| | | | | |     | |   | | | | | |
+ + + + + + +-+ + + + + + + + + +
| | | | |   |   |   | |   | | | |
+ + + + +-+-+ +-+ +-+-+ + + + + +
|   | |         |     | | |   | |
+ + + + +-+-+ +-+ +-+-+-+-+-+ + +
| | |           |             | |
+ + +-+-+-+-+-+-+-+-+-+-+-+-+-+ +
| |                             |
.-+-+-+-+-+-+-+-+-+-+-+-+-+-+-+-+